%%%%%%%%%%
%     G  %
%     %%%%
%     %  %
%     % P%
%        %
%%%%%%%%%%
% % % %%%%
%%%%%%%%%%
