%%%%%%%%%%%%%%
%            %
%  %    %%%%%%
%%%%         %
%G %      %%%%
%         %  %
%%%       %  %
%           P%
%%%%%%%%%%%%%%
% % % %%%%%%%%
%%%%%%%%%%%%%%
