%%%%%%%%%%%%%%
%            %
%G %    %%%%%%
%%%%         %
%  %      %%%%
%         %  %
%%%       %  %
%           P%
%%%%%%%%%%%%%%
% % % %%%%%%%%
%%%%%%%%%%%%%%
