%%%%%%%%%%
%        %
% G%     %
%%%%     %
%  %     %
%        %
%%%      %
%       P%
%%%%%%%%%%
% % % %%%%
%%%%%%%%%%
