%%%%%%%%%%%%%%
%        P   %
%       %%%%%%
%          G %
%            %
%%%%%%%%%%%%%%
% % % %%%%%%%%
%%%%%%%%%%%%%%
