%%%%%%%%%%%%%%
%    P       %
%%%%%%%      %
%  G         %
%            %
%%%%%%%%%%%%%%
% % % %%%%%%%%
%%%%%%%%%%%%%%
