%%%%%%%%%%%%%%
%            %
%         P  %
%       %%%%%%
%G           %
%            %
%%%%%%%%%%%%%%
% % % %%%%%%%%
%%%%%%%%%%%%%%
