%%%%%%%%%%%%%%
%           G%
%       %%%%%%
%           P%
%            %
%%%%%%%%%%%%%%
% % % %%%%%%%%
%%%%%%%%%%%%%%
