%%%%%%%%%%%%%%
%    G       %
%%%%%%%      %
%P           %
%            %
%%%%%%%%%%%%%%
% % % %%%%%%%%
%%%%%%%%%%%%%%
