%%%%%%%%%%%%%%
%         G  %
%       %%%%%%
%           P%
%            %
%%%%%%%%%%%%%%
% % % %%%%%%%%
%%%%%%%%%%%%%%
