%%%%%%%%%%%%%%
%          G %
%       %%%%%%
%          P %
%            %
%%%%%%%%%%%%%%
% % % %%%%%%%%
%%%%%%%%%%%%%%
