%%%%%%%%%%%%%%
%  G         %
%%%%%%%      %
%  P         %
%            %
%%%%%%%%%%%%%%
% % % %%%%%%%%
%%%%%%%%%%%%%%
