%%%%%%%%%%%%%%
%            %
%      G%%%%%%
%          P %
%            %
%%%%%%%%%%%%%%
% % % %%%%%%%%
%%%%%%%%%%%%%%
