%%%%%%%%%%%%%%
%G           %
%%%%%%%      %
%  P         %
%            %
%%%%%%%%%%%%%%
% % % %%%%%%%%
%%%%%%%%%%%%%%
