%%%%%%%%%%%%%%
%        G   %
%       %%%%%%
%          P %
%            %
%%%%%%%%%%%%%%
% % % %%%%%%%%
%%%%%%%%%%%%%%
