%%%%%%%%%%%%%%
%    G       %
%%%%%%%      %
%  P         %
%            %
%%%%%%%%%%%%%%
% % % %%%%%%%%
%%%%%%%%%%%%%%
