%%%%%%%%%%%%%%
%           P%
%       %%%%%%
%G           %
%            %
%%%%%%%%%%%%%%
% % % %%%%%%%%
%%%%%%%%%%%%%%
