%%%%%%%%%%%%%%
%   P        %
%%%%%%%      %
%G           %
%            %
%%%%%%%%%%%%%%
% % % %%%%%%%%
%%%%%%%%%%%%%%
