%%%%%%%%%%%%%%
%          P %
%       %%%%%%
%          G %
%            %
%%%%%%%%%%%%%%
% % % %%%%%%%%
%%%%%%%%%%%%%%
