%%%%%%%%%%%%%%
%  P         %
%%%%%%%      %
%  G         %
%            %
%%%%%%%%%%%%%%
% % % %%%%%%%%
%%%%%%%%%%%%%%
