%%%%%%%%%%%%%%
%           P%
%       %%%%%%
%         G  %
%            %
%%%%%%%%%%%%%%
% % % %%%%%%%%
%%%%%%%%%%%%%%
