%%%%%%%%%%%%%%
%P           %
%%%%%%%      %
%  G         %
%            %
%%%%%%%%%%%%%%
% % % %%%%%%%%
%%%%%%%%%%%%%%
