%%%%%%%%%%%%%%
%          G %
%     %%%%%%%%
%           P%
%%%%%%%%%%%%%%
% % % %%%%%%%%
%%%%%%%%%%%%%%
