%%%%%%%%%%%%%%
%           G%
%     %%%%%%%%
%            %
%           P%
%%%%%%%%%%%%%%
% % % %%%%%%%%
%%%%%%%%%%%%%%
