%%%%%%%%%%%%%%
%G           %
%%%%%%%      %
%            %
%   G        %
%            %
%  G         %
%            %
%           P%
%%%%%%%%%%%%%%
% % % %%%%%%%%
%%%%%%%%%%%%%%
