%%%%%%%%%%%%%%
%           P%
%            %
%            %
%    G       %
%            %
%            %
%            %
%%%%%%%%%%%%%%
% %%%%%%%%%%%%
%%%%%%%%%%%%%%
