%%%%%%%%%%%%%%
%G           %
%%%%%%      G%
%..       %%%%
%%%%         %
%G           %
%%%%         %
%           P%
%%%%%%%%%%%%%%
% % % %%%%%%%%
%%%%%%%%%%%%%%
