%%%%%%%%%%%%%%
%GP %        %
%%%%%        %
%            %
%            %
%            %
%            %
%            %
%%%%%%%%%%%%%%
% %%%%%%%%%%%%
%%%%%%%%%%%%%%
