%%%%%%%%%%%%%%
%            %
%            %
%            %
%      G     %
%            %
%            %
%           P%
%%%%%%%%%%%%%%
% %%%%%%%%%%%%
%%%%%%%%%%%%%%
