%%%%%%%%%%%%%%
%P           %
%            %
%            %
%            %
%            %
%            %
%           G%
%%%%%%%%%%%%%%
% %%%%%%%%%%%%
%%%%%%%%%%%%%%
