%%%%%%%%%%%%%%
%           P%
%            %
%            %
%            %
%            %
%            %
%G           %
%%%%%%%%%%%%%%
% %%%%%%%%%%%%
%%%%%%%%%%%%%%
