%%%%%%%%%%%%%%
%     G     P%
%            %
%            %
%            %
%            %
%            %
%            %
%%%%%%%%%%%%%%
% %%%%%%%%%%%%
%%%%%%%%%%%%%%
