%%%%%%%%%%%%%%
%           G%
%            %
%            %
%            %
%            %
%            %
%           P%
%%%%%%%%%%%%%%
% %%%%%%%%%%%%
%%%%%%%%%%%%%%
