%%%%%%%%%%%%%%
%            %
%            %
%            %
%      G     %
%            %
%            %
%P           %
%%%%%%%%%%%%%%
% %%%%%%%%%%%%
%%%%%%%%%%%%%%
