%%%%%%%%%%%%%%
%P           %
%            %
%            %
%     G      %
%            %
%            %
%            %
%%%%%%%%%%%%%%
% %%%%%%%%%%%%
%%%%%%%%%%%%%%
