%%%%%%%%%%%%%%
%            %
%            %
%            %
%     G      %
%            %
%            %
%     P      %
%%%%%%%%%%%%%%
% %%%%%%%%%%%%
%%%%%%%%%%%%%%
