%%%%%%%%%%%%%%
%            %
%            %
%            %
%P    G      %
%            %
%            %
%            %
%%%%%%%%%%%%%%
% %%%%%%%%%%%%
%%%%%%%%%%%%%%
