%%%%%%%%%%%%%%
%         G  %
%            %
%          % %
%          % %
%          %P%
%          % %
%%%%%%%%%%%%%%
% % % %%%%%%%%
%%%%%%%%%%%%%%