%%%%%%%%%%%%%%
%            %
%            %
%          % %
%          % %
%          % %
%         P%G%
%%%%%%%%%%%%%%
% % % %%%%%%%%
%%%%%%%%%%%%%%
