%%%%%%%%%%%%%%
%            %
%            %
%          % %
%          %G%
%          % %
%         P% %
%%%%%%%%%%%%%%
% % % %%%%%%%%
%%%%%%%%%%%%%%
