%%%%%%%%%%%%%%
%         P% %
%          % %
%          %G%
%          % %
%            %
%            %
%%%%%%%%%%%%%%
% % % %%%%%%%%
%%%%%%%%%%%%%%
