%%%%%%%%%%%%%%
%            %
%          G %
%          % %
%          % %
%          % %
%         P% %
%%%%%%%%%%%%%%
% % % %%%%%%%%
%%%%%%%%%%%%%%
