%%%%%%%%%%%%%%
%         P% %
%          % %
%          % %
%          % %
%          G %
%            %
%%%%%%%%%%%%%%
% % % %%%%%%%%
%%%%%%%%%%%%%%
