%%%%%%%%%%%%%%
%           G%
%            %
%          % %
%          % %
%          % %
%         P% %
%%%%%%%%%%%%%%
% % % %%%%%%%%
%%%%%%%%%%%%%%
