%%%%%%%%%%%%%%
%          %G%
%         P% %
%          % %
%          % %
%            %
%            %
%%%%%%%%%%%%%%
% % % %%%%%%%%
%%%%%%%%%%%%%%
