%%%%%%%%%%%%%%
%            %
%            %
%          % %
%          % %
%         P% %
%          %G%
%%%%%%%%%%%%%%
% % % %%%%%%%%
%%%%%%%%%%%%%%
