%%%%%%%%%%%%%%
%          % %
%          % %
%         P%G%
%          % %
%            %
%            %
%%%%%%%%%%%%%%
% % % %%%%%%%%
%%%%%%%%%%%%%%
