%%%%%%%%%%%%%%
%            %
%            %
%          % %
%          % %
%         G%P%
%          % %
%%%%%%%%%%%%%%
% % % %%%%%%%%
%%%%%%%%%%%%%%
