%%%%%%%%%%%%%%
%         G%P%
%          % %
%          % %
%          % %
%            %
%            %
%%%%%%%%%%%%%%
% % % %%%%%%%%
%%%%%%%%%%%%%%
