%%%%%%%%%%%%%%
%            %
%            %
%          % %
%         G% %
%          %P%
%          % %
%%%%%%%%%%%%%%
% % % %%%%%%%%
%%%%%%%%%%%%%%
