%%%%%%%%%%%%%%
%          %P%
%          % %
%         G% %
%          % %
%            %
%            %
%%%%%%%%%%%%%%
% % % %%%%%%%%
%%%%%%%%%%%%%%
