%%%%%%%%%%%%%%
%            %
%            %
%          % %
%          % %
%          %P%
%         G% %
%%%%%%%%%%%%%%
% % % %%%%%%%%
%%%%%%%%%%%%%%