%%%%%%%%%%%%%%
%P           %
%%%%%%%%%    %
%G           %
%%%%%%%%%%%%%%
% % % %%%%%%%%
%%%%%%%%%%%%%%
