%%%%%%%%%%%%%%
%           P%
%     %%%%%%%%
%           G%
%%%%%%%%%%%%%%
% % % %%%%%%%%
%%%%%%%%%%%%%%
