%%%%%%%%%%%%%%
% G          %
%%%%%%%%%    %
%P           %
%%%%%%%%%%%%%%
% % % %%%%%%%%
%%%%%%%%%%%%%%
