%%%%%%%%%%%%%%
%P           %
%%%%%%%%%    %
% G          %
%            %
%%%%%%%%%%%%%%
% % % %%%%%%%%
%%%%%%%%%%%%%%
