%%%%%%%%%%%%%%
%G           %
%%%%%%%%%    %
%P           %
%            %
%%%%%%%%%%%%%%
% % % %%%%%%%%
%%%%%%%%%%%%%%
